강대식	NNP
국민의힘	NNP
BTS	NNP
찬반	NNG
가이드라인	NNG
더불어민주당	NNP
안민석	NNP
윤상현	NNP
성일종	NNP
국방부	NNP
안철수	NNP
자카르타	NNP
대선후보	NNG
팔렘방아시안게임	NNP
손흥민	NNP
국익	NNG
기회	NNG
대체복무	NNG
청년	NNG
비결	NNG
전염력	NNG